000000000000000000000000000
000000000000000000000000000
000000000000000000000000000
000000000000000000000000000
000000000000000000000000000
000000000000000000000000000
111111111100011111122222200
000000000000000000022222200
000000000000000000022222200